###############
#M___#______###
#_##___##___###
#__###_##_#####
##_#______#####
##_#_####_#####
##_#_####___###
#____####_#####
#_##_####___###
#_##___####_###
#_####_####_#_#
#_#____####___#
#___###___###_#
###_____#_____#
#############G#