M______########
#__###_########
#_####_##__T###
#__###_##_#####
##_#______#####
##_#_####_#####
##_#_####__N###
#__#_####_#####
#_##_####___###
#_##___####_###
#_####_####_#_#
#_#____####___#
#E__#########_#
#############G#
#############S#