M_#############
#____#______###
#_##___####___#
#__###_###__#_#
##_#_______##_#
##_#_#_##_###_#
##_#_#_##_###_#
#____#_##_##__#
#_##_#_##____##
#_##___####_###
#_####_####_###
#_#____####___#
#___###___###_#
###_____#____G#
###############